.....W..W....W.W
..W.S...W.W....W
..........WWWW.W
........W.W....W
WWWWWW..W.W..W.W
EW......W.W..W.W
.WWWWWWWW.W..W.W
.W........W....W
.W.WWWWWW.W..W.W
.W..WWWWW.W....W
.WW...W...W..W.W
.....W..........